firefox	firefox
kalkulator	gnome-calculator
libreoffice	libreoffice
office	libreoffice
gedit	gedit
vlc	vlc
display	display
edytor	gedit
edytora	gedit
edytor	gedit
notatnika	gedit
notatnika	gedit
notatnik	gedit
graficzny	gimp
sublime	subl
przeglądarka	firefox
przeglądarkę	firefox
odtwarzacz	vlc
ustawienia	unity-control-center
graficzny	gimp
muzyczny	vlc